cnt	fromCnt	toCnt	orgIDCnt	orgNameNorm	orgName	term
21	21	0	0	ДОВІРА	Депутатська група "ДОВІРА"	9
22	22	22	0	За майбутнє	Депутатська група "За майбутнє"	9
26	26	4	0	За майбутнє	Депутатська група "Партія "За майбутнє"	9
453	453	425	0	Позафракційні	Позафракційні	9
26	26	0	0	Європейська солідарність	Фракція політичної партії "Європейська солідарність"	9
21	21	1	0	ГОЛОС	Фракція політичної партії "ГОЛОС"	9
44	44	1	0	ОПОЗИЦІЙНА ПЛАТФОРМА - ЗА ЖИТТЯ	Фракція політичної партії "ОПОЗИЦІЙНА ПЛАТФОРМА-ЗА ЖИТТЯ"	9
263	263	15	0	СЛУГА НАРОДУ	Фракція політичної партії "СЛУГА НАРОДУ"	9
26	26	1	0	Всеукраїнське об’єднання "Батьківщина"	Фракція політичної партії Всеукраїнське об’єднання "Батьківщина"	9
20	0	0	20	ДОВІРА	групи "ДОВІРА"	9
21	0	0	21	За майбутнє	групи "Партія "За майбутнє"	9
27	0	0	27	ЄВРОПЕЙСЬКА СОЛІДАРНІСТЬ	фракції ПОЛІТИЧНОЇ ПАРТІЇ "ЄВРОПЕЙСЬКА СОЛІДАРНІСТЬ"	9
241	0	0	241	СЛУГА НАРОДУ	фракції ПОЛІТИЧНОЇ ПАРТІЇ "СЛУГА НАРОДУ"	9
20	0	0	20	ГОЛОС	фракції Політичної Партії "ГОЛОС" у Верховній Раді України дев’ятого скликання	9
44	0	0	44	ОПОЗИЦІЙНА ПЛАТФОРМА - ЗА ЖИТТЯ	фракції Політичної партії "ОПОЗИЦІЙНА ПЛАТФОРМА - ЗА ЖИТТЯ" у Верховній Раді України	9
25	0	0	25	Всеукраїнське об’єднання "Батьківщина"	фракції політичної партії Всеукраїнське об’єднання "Батьківщина" у Верховній Раді України дев’ятого скликання	9
